NO ./texture/crab.png 
SO ./texture/dolphin.png
WE ./texture/fish.png
EA ./texture/eyes.png

C 22,117,135
F 92,209,217


1111111111111111111111111111111
1101000100110000000001E000000111
11000000000000000000001101111
10000000000000000000000001111
10000000001000000000000001111111
100000000000000000000000000101011
110001000001111000000000100000011
10000000011   100000000000011111
11000000011    10000000000111111
100000100001111000000000000111
110000010000000000000000001111
100000000000000100000100000111
111111000100000000100000000111
     1000010001000100010000001
111  1000000000000001000101111
101111000000010001000000100001
1100000000100000010000000011111
1010101010101010001010101011111
11111111 1111111011111111111111
                1